
Iceland	Iceland
Ireland	Ireland
United Kingdom	United Kingdom
Norway	Norway
Sweden	Sweden
Finland	Finland
Estonia	Estonia
Latvia	Latvia
Lithuania	Lithuania
Poland	Poland
Germany	Germany
Netherlands	Netherlands
Switzerland	Switzerland
Czech Republic	Czech Republic
Austria	Austria
Slovakia	Slovakia
Romania	Romania
Hungary	Hungary
Slovenia	Slovenia
Croatia	Croatia
Bulgaria	Bulgaria
Italy	Italy
France	France
Spain	Spain
Portugal	Portugal
Belgium	Belgium

